SO ./textures/chiseled_tuff.xpm
NO ./textures/chiseled_tuff_bricks.xpm
WE ./textures/chiseled_stone_bricks.xpm
EA ./textures/chiseled_tuff_bricks_top.xpm

F 0,255,0
C 0,255,255

111111
1NEWS1
111111
