SO ./textures/b.xpm
NO ./textures/wasteland_32.xpm
WE ./textures/sandy_32.xpm
EA 									   ./textures/cobblestone_32.xpm

F 0,255,0
C 0,123,255




11111111111111111111
10000011000001010101
10000011000000000001
10111111111111000101
1011         1000000
10111111    11000100
10000011111110000000
100000000000000N0000
11111111111111111111
