SO ./textures/png_ugly.png
NO ./textures/png_ugly.png
WE ./textures/png_pretty.png
EA ./textures/png_pretty.png

F 255,255,255
C 255,255,255













1111
00N1
1111
