SO ./textures/png_ugly.png
NO ./textures/png_ugly.png
WE ./textures/png_pretty.png
EA ./textures/png_pretty.png

F 255,255,255
C 255,255,255













111
1N11111
1000xy1
1111111
