SO ./textures/a.xpm
NO ./textures/a.xpm
WE ./textures/a.xpm
EA ./textures/a.xpm

F 255,255,255
C 255,255,255













11111111111111111111111
100000000N0000000000001
10000000000000000000001
10000000000000000000001
11111011101100111110011
11000000000000000000001
11110111111111111111111
11111111
